SO ./testxpm/wall.xpm

WE ./testxpm/wall.xpm

NO ./testxpm/wall.xpm
EA ./testxpm/wall.xpm


F 220,100,0
C 225,30,0


1111111111111111111111111
10000000001100000F0000001
1011000001110000000000001
1001000000D0000000000000111111111
1111111110110000011100000000000F1
100000000011000001110111111111111
1111D111111111011100000010001
11110111111111011101010010001
110000001101010111000000D0001
10000000000000000000000010001
1F000000000F00000001010010001
11000001110101011111011110N0111
11110111 1110101 101111010001
11111111 1111111 111111111111