NO ./testxpm/wall.xpm
SO ./testxpm/wall.xpm
WE ./testxpm/wall.xpm
EA ./testxpm/wall.xpm


F 220,100,0
C 225,30,0


        111111111111111111111111
        100000000000000000000001
        10000000000F000000000001
11111111100000000000000000000001
10000011111000000000000111111111
1000001000100000000000S1
100000100010000000000001
100000100010000000000001
1000001DD110000000000001
10000000000000000F000001
100000000000000000000001
10F000000000100000000001
100000000000010000000001
100000100000000000000001
100001000000000000000001
100000000000000000000001
111111111000000000000001
110100001000000000000001
110000001000000000000001
110100001000000000000001
110111111000000000000001
11000D00000000000F000001
111111111000000000000001
111111111000000000000001
111111111000000000000001
111111111000000000000001
111111111000000000000001
111111111000000000000001
111111111111111111111111