SO ./testxpm/wall.xpm
WE ./testxpm/wall.xpm
NO ./testxpm/wall.xpm
EA ./testxpm/wall.xpm

F 220,100,0
C 225,30,0

1111111111111111111111111111111111111111111111111
1000000000D00000000000000000D00000000000000000001
1000011111111111100000111111111111100000000000001
1000D10000000000100000100000000000100D00000000001
100001000000D000100D001000000D0000111111111111101
100000000000000010000010000000000000000F000000101
10000111001110001000001001011111111111111111001F1
1000010000001000111111100100000000000000000000101
1000010000001000000F000001000000F0000000111111101
100001000F001111111111111100000000000000100000001
1011110000000000000000000000000000000000100000001
10100001111111111F000000000000F111111111100000001
1F1000000000000F11111111111111110000F000101111001
10100000000000000000000F0000000000000000101000001
10111111111100011111111111111111111111001F1000001
1000000000F10001F00000000000000F00000000101000001
1000000000011111000000000111111111111111101111001
1000000000000F00000000000100000000010000000000001
1F000000000111110000000001000000000100000F0000001
100000100001000000000000F100000F00010100000000001
1000001111110011111111111100000000010100000000001
100000000000001000000000000000000001F1F0000000001
1011111111111D11111111111111111111110111111111101
101000000000000000000000F0000000000001000F0000101
1F100F00001111111111111111111111111000000000001F1
101000000000000F0000000000000000001F0000000000101
10111111111111111110000000111111001111111111101D1
1000000000F00000001111111110000000000000F00000001
1N00000000000000000000F00000000000000000000000001
1111111111111111111111111111111111111111111111111